行動を代わる	に	人間に
記述をする	と	主体と
注目を集める	が	サポートベクターマシンが
経験を行う	に を	元に 学習を
学習をする	て で に は を を通して	なされている ACT-Rでは 推論ルールを 元に 生成規則を通して
進化を見せる	て において は	活躍している 敵対的生成ネットワークは 加えて 生成技術において
進化をいる	て において は	活躍している 敵対的生成ネットワークは 加えて 生成技術において
開発を行う	は	エイダ・ラブレスは
処理を行う	に により	同年に ティム・バーナーズリーにより Webに
処理をせる	に により	同年に ティム・バーナーズリーにより Webに
意味をする	に	データに
処理を行う	て に	付加して コンピュータに
処理をせる	て に	付加して コンピュータに
研究を進める	て	費やして
命令をする	で	機構で
運転をする	に	元に
特許をする	が に まで	2018年までに 日本が
特許をいる	が に まで	2018年までに 日本が
運転をする	て に	基づいて 柔軟に
注目を集める	から は	ことから ファジィは
制御を用いる	て も	受けて 他社も
制御をする	から	少なさから
改善を果たす	が で に	2012年に 画像処理コンテストで チームが
研究を続ける	が て	ジェフホーキンスが 向けて
研究をいる	が て	ジェフホーキンスが 向けて
)をする	に は	8月には
注目を集める	に	急速に
投資を行う	で に	全世界的に 民間企業主導で
探索を行う	で	無報酬で
推論をする	て	経て
研究を始める	とも は	Googleは マックスプランク研究所とも
研究をおる	とも は	Googleは マックスプランク研究所とも
研究を行う	て	始めており
研究をいる	て	始めており
開発をする	で は	中国では 官民一体で
開発をてる	で は	中国では 官民一体で
開発をする	で	日本で
開発をいる	で	日本で
投資をする	に は まで	韓国は 2022年までに
反乱を起こす	て に対して	於いて 人間に対して
監視を行う	に まで	歩行者まで 人工知能に
監視をせる	に まで	歩行者まで 人工知能に
手続きを経る	を	ウイグル族を
制御をする	は	AIプログラムは
制御をおる	は	AIプログラムは
判断を介す	から	観点から
禁止を求める	が に は	4月には ヒューマン・ライツ・ウォッチが
禁止をいる	が に は	4月には ヒューマン・ライツ・ウォッチが
競争を行う	は をめぐって	米国中国ロシアは 軍事利用をめぐって
競争をいる	は をめぐって	米国中国ロシアは 軍事利用をめぐって
追及を受ける	て で と とともに は	暴露されており 公聴会では とともに 拒否すると 整合性で
研究をする	が	Microsoftが
解任をする	て は	含まれており Google社員らは
解散をする	が で は	Googleは 倫理委員会が 理由で
存在を見いだす	に	ものに
話をする	は	哲学者は
話をいる	は	哲学者は
議論を行う	まで	これまで
議論をくる	まで	これまで
